NO ./maps/assets/CONCRETE_2A.xpm
SO ./maps/assets/VENT_1A.xpm
WE ./maps/assets/TECH_1A.xpm
EA ./maps/assets/TECH_3G.xpm

F 20,22,25
C 13,14,15

        1111111111111111111111111
        1000000000000000000000001
        1000000000100001111111111
        1000000001E10001
111111110000000000100001
10000000000000000000000011111
111111111111111P0000000000001
100000000000000P0000000000001
100001111111111P0000000000001
10000000000000000000000000001
10000000000000011111100000001
1001111111000001    100000011
10000011 1000001    100000001
11111111 1111111    111111111
